*********
*..*....*
**.*.****
**...****
***.*****
*.......*
*.*****.*
*.......*
*********