111111111111111
102000010000001
101111000111101
101111101111101
100000000030001
110110111011111
110110000011111
110000111011111
110111111011111
100000000000001
101101111111101
100000000000001
101111111011101
100000000000001
111111111111111