111111111111111
10200001C000001
101111000111101
101111101111101
100000000000001
110110111011101
110110000011101
11B000111011101
110111111011101
100000000000001
101101111111101
10000I000000001
101111111011101
10P000000000001
111111111111111