111111111111111
102000014000701
101101000110101
101101101110101
100000000000001
110110111010101
110110000010101
115000011000001
110111011011101
107000000000001
101101111111101
100006000000001
101110111011101
103000000007001
111111111111111